{
    "name": "Scenario 00",
    "info": "None",

    "mapMatrix" : [
        [ 2, 2, 2, 2, 2, 2, 2, 2, 2, 2 ],
        [ 2, 1, 1, 1, 1, 1, 1, 1, 1, 2 ],
        [ 2, 1, 1, 1, 1, 1, 1, 1, 1, 2 ],
        [ 2, 1, 1, 1, 1, 1, 1, 1, 1, 2 ],
        [ 2, 1, 1, 1, 1, 1, 1, 1, 1, 2 ],
        [ 2, 1, 1, 1, 1, 1, 1, 1, 1, 2 ],
        [ 2, 1, 1, 1, 1, 1, 1, 1, 1, 2 ],
        [ 2, 1, 1, 1, 1, 1, 1, 1, 1, 2 ],
        [ 2, 1, 1, 1, 1, 1, 1, 1,16, 2 ],
        [ 2, 2, 2, 2, 2, 2, 2, 2, 2, 2 ]
    ]
}