{
    "name": "Scenario 01",
    "info": "None",

    "mapMatrix" : [
        [ 2, 2, 2, 2, 2, 2, 2, 2, 2, 2 ],
        [ 2, 6, 2, 2, 1, 1, 1, 1, 1, 2 ],
        [ 2, 1, 1, 2, 1, 2, 2, 2, 1, 2 ],
        [ 2, 2, 1, 1, 1, 1, 1, 2, 1, 2 ],
        [ 2, 1, 1, 2, 2, 2, 2, 2, 1, 2 ],
        [ 2, 1, 2, 2, 3, 3, 2, 1, 1, 2 ],
        [ 2, 1, 2, 1, 1, 1, 2, 1, 2, 2 ],
        [ 2, 1, 2, 1, 2, 1, 2, 1, 1, 2 ],
        [ 2, 1, 1, 1, 2, 1, 1, 1,16, 2 ],
        [ 2, 2, 2, 2, 2, 2, 2, 2, 2, 2 ]
    ]
}