{
    "name": "Scenario 10",
    "info": "None",

    "mapMatrix" : [
        [ 2, 2, 2, 2, 2, 2, 2, 2, 2, 2 ],
        [ 2, 1,11, 1, 3,13, 2, 1, 6, 2 ],
        [ 2, 1, 1, 1, 3, 1, 2, 8, 2, 2 ],
        [ 2, 1, 1, 1, 3, 1, 1, 1,14, 2 ],
        [ 2, 1, 1, 1, 3, 2, 7, 2, 2, 2 ],
        [ 2, 9, 1, 1, 4, 1, 1, 1, 1, 2 ],
        [ 2, 3, 3, 3, 3, 1, 1, 1, 1, 2 ],
        [ 2, 1, 1,15, 5, 1, 1,16, 1, 2 ],
        [ 2,10, 1, 1, 3, 1, 1, 1, 1, 2 ],
        [ 2, 2, 2, 2, 2, 2, 2, 2, 2, 2 ]
    ]
}