{
    "name": "Scenario 04",
    "info": "None",

    "mapMatrix" : [
        [ 2, 2, 2, 2, 2, 2, 2, 2, 2, 2 ],
        [ 2, 1, 1, 1, 1, 2, 3, 1,11, 2 ],
        [ 2, 1, 2, 2, 1,16, 4,15, 1, 2 ],
        [ 2, 1, 1, 2, 2, 2, 3, 2, 2, 2 ],
        [ 2, 2, 1, 2, 1, 1, 4, 1, 9, 2 ],
        [ 2, 2, 1, 2, 1, 3, 3, 2, 2, 2 ],
        [ 2, 2, 1, 1, 1, 5, 1, 1, 1, 2 ],
        [ 2, 2, 7, 2, 2, 3, 1, 6, 1, 2 ],
        [ 2,13, 1,14, 2, 3, 1, 1, 1, 2 ],
        [ 2, 2, 2, 2, 2, 2, 2, 2, 2, 2 ]
    ]
}